{
    "mapInfos": {"width": 7, "height": 7},
    "map": [
        [1, 1, 1, 1, 1, 1, 1, 1, 1, 1, 1],
        [1, 0, 0, 0, 0, 0, 0, 0, 0, 0, 1],
	    [1, 0, 3, 0, 0, 0, 0, 0, 0, 0, 1],
        [1, 0, 0, 0, 0, 0, 3, 0, 0, 0, 1],
	    [1, 0, 0, 0, 0, 0, 0, 0, 0, 0, 1],
	    [1, 0, 0, 0, 0, 0, 4, 0, 0, 0, 1],
	    [1, 0, 4, 0, 0, 0, 0, 0, 0, 0, 1],
	    [1, 0, 0, 0, 0, 0, 0, 0, 0, 0, 1],
	    [1, 0, 5, 0, 0, 0, 5, 0, 0, 0, 1],
	    [1, 0, 0, 0, 0, 0, 0, 0, 0, 0, 1],
        [1, 1, 1, 1, 1, 1, 1, 1, 1, 1, 1]
    ],
    "destructibleBlock": [{ "x": 0, "y": 0 }, [0,1]],
    "bonus": []
}
