{
    "mapInfos": {"width": 7, "height": 7},
    "map": [
        [1, 1, 1, 1, 1, 1, 1, 1, 1, 1, 1],
        [1, 0, 0, 0, 0, 0, 0, 0, 0, 0, 1],
	    [1, 0, 0, 0, 0, 0, 0, 0, 1, 0, 1],
        [1, 0, 0, 0, 0, 0, 0, 0, 0, 0, 1],
	    [1, 0, 0, 0, 0, 0, 0, 0, 0, 0, 1],
	    [1, 0, 0, 0, 0, 0, 0, 1, 0, 0, 1],
	    [1, 0, 0, 0, 0, 0, 0, 0, 0, 0, 1],
	    [1, 0, 0, 0, 0, 0, 0, 0, 0, 0, 1],
	    [1, 0, 0, 0, 0, 0, 0, 0, 0, 0, 1],
	    [1, 0, 0, 0, 0, 0, 0, 0, 0, 0, 1],
        [1, 1, 1, 1, 1, 1, 1, 1, 1, 1, 1]
    ],
    "destructibleBlock": [{ "x": 0, "y": 0 }, [0,1]],
    "bonus": []
}
